BBFF8675
817798B8
88E77988
13282234
AC8F88B8
57373D88
4E277798
A7377779
